{"##  ####################################  ##"},
{"#..........................................#"},
{" .#######    #######    #######    #######. "},
{" .#......................................#. "},
{"#. .################ ## ################. .#"},
{"#. .      .....      ##      .....      . .#"},
{"#.#.# # ##############################  .#.#"},
{"#.#.# # #            ##              # #.#.#"},
{"#. .# #.# #########  ##  ########### #.#. .#"},
{"## .# #.  # E        ##        P   #  .#. ##"},
{"#. .# #.# #########  ##  ########### #.#. .#"},
{"#.#.# # #            ##              # #.#.#"},
{"#.#.# # ##############################  .#.#"},
{"#. .      .....      ##      .....      . .#"},
{"#. .################ ## ################. .#"},
{" .#......................................#. "}
{" .#######    #######    #######    #######. "},
{"#..........................................#"},
{"##  ####################################  ##"}